111111
1P00E1
100001
100101
1C0101
111111