11111111111111111111
1P1C11000000000E0001
10101100000000111001
101000000000001C1001
10000000000000001001
1C101111110101001001
10100000010101001001
11111111111111111111