11111111111111111111
101C1100P01010000001
10101100000100111E01
100000000000001C1001
10000000000000001001
10101111110111001001
1C100000C10101101001
11111111111111111111