11111111111111111111
10101100P01010000001
10101100000100111E01
10000000000000101001
10000000000000001001
10101111110111001001
1C100000000101101001
11111111111111111111
